das Eiweiß - белок
das Klavier - фортепиано
der Schlaf - сон как таковой
der Traum - сон который сниться
das Geschlecht - пол
das Genus - гендер
die Traurigkeit - грусть
Überlegenheit - превосходство
der Fuß - ступня 
das Bein - нога
der Arm/Arme - рука, руки
der Dienstbote - слуга
das Versprechen - обещание
Ratschlag (Ratschläge) - совет, советы
der Menge - большинство
die Eile (Eilen) - спешка/спешки
die Ruhe (Ruhen) - состояние/я покоя, бездействие/я
die Demut (nur Einzahl) - смирение, покорность
der Strand (Strandes) - пляж(и)
der Zweifel - сомнение
grad (сокращение от gerade) - прямо сейчас, только что, аккуратно, ровно, вполне, точно, прямо
beliebt - популярный
wunderbar - чудесный, замечательный
holen - приносить, привозить
unendlich - безконечно
träumen - видеть сны
traurig - грустный
singen - петь
wunderlich - причудливый
überhaupt - совсем
erinnern - помнить.
lassen - let, позволить
gefällen - нравится
messen - мерять
entschieden - решать
glaube - верю, думаю
versprechen - обещать 
abschieden - прощаться
überreden - умолять, убеждать эмоционально
überzeugen - убеждать аргументами
schweigen - молчать
dort - там
fest - сильно, твердо, жестко (Ich glaube fest an dich)
jemand - кто-то
niemand - никто
weil - потому что, так как
da - потому что, так как
dann - потому что, так как
dass - что (that)
gemeinsam - вместе
einsam - одинокий
rumsitzen - сидеть без дела.
statt - вместо
gemeint - иметь в виду
schau mal - глянь, take a look
schauen - смотреть
anzeigen - показывать
Abschied nehmen - прощаться
dazu - кроме того
eigentlich - на самом деле
sogar - даже
gar - даже
beraten - советовать
einfach - простой, не сложный
bewegen - двигать, передвигать
kreisen - крутиться, циркулировать
daran - при этом, потому что, к этому (because)
irgendwo - где-то
Inmitten - посреди
Stell dir vor - представь себе
lass - позволить, оставить, положить и оставить, let
die Klugheit - мудрость
versprechen - обещать
das Versprechen - обещание
der Abschied - прощание
Abschied nehmen - прощаться
die Hose - брюки
die Schuh - обувь
die Klamotten - одежда
die Lederjacke - кожанка
die Jacke - пиджак
altmodish - старомодный
pass mal auf - послушай сюда, смотри сюда, давай так.
der Schlafanzug - пижама
erkältet - простудился
aufwachen - просыпатся
geschehen - случатся, happend
davon - об этом
Sehenswürdigkeit - достопримечательность
die Überweisung - перевод (денег), направление (к врачу специалисту)
unterschtützen - одобрять
